  ___       _                      _                        _    _               _      _
 / _ \     | |                    | |                      | |  | |             | |    | |
/ /_\ \  __| |__   __  ___  _ __  | |_  _   _  _ __   ___  | |  | |  ___   _ __ | |  __| |
|  _  | / _` |\ \ / / / _ \| '_ \ | __|| | | || '__| / _ \ | |/\| | / _ \ | '__|| | / _` |
| | | || (_| | \ V / |  __/| | | || |_ | |_| || |   |  __/ \  /\  /| (_) || |   | || (_| |
\_| |_/ \__,_|  \_/   \___||_| |_| \__| \__,_||_|    \___|  \/  \/  \___/ |_|   |_| \__,_|