
 / \-----     ---------  -----------     -------------- ------    ----\
 \_/__________________________________________________________________/
 |~ ~~ ~~~ ~ ~ ~~~ ~ _____.----------._ ~~~  ~~~~ ~~   ~~  ~~~~~ ~~~~|
 |  _   ~~ ~~ __,---'_       "         `. ~~~ _,--.  ~~~~ __,---.  ~~|
 | | \___ ~~ /      ( )   "          "   `-.,' (') \~~ ~ (  / _\ \~~ |
 |  \    \__/_   __(( _)_      (    "   "     (_\_) \___~ `-.___,'  ~|
 |~~ \     (  )_(__)_|( ))  "   ))          "   |    "  \ ~~ ~~~ _ ~~|
 |  ~ \__ (( _( (  ))  ) _)    ((     \\//    " |   "    \_____,' | ~|
 |~~ ~   \  ( ))(_)(_)_)|  "    ))    //\\ " __,---._  "  "   "  /~~~|
 |    ~~~ |(_ _)| | |   |   "  (   "      ,-'~~~ ~~~ `-.   ___  /~ ~ |
 | ~~     |  |  |   |   _,--- ,--. _  "  (~~  ~~~~  ~~~ ) /___\ \~~ ~|
 |  ~ ~~ /   |      _,----._,'`--'\.`-._  `._~~_~__~_,-'  |H__|  \ ~~|
 |~~    / "     _,-' / `\ ,' / _'  \`.---.._          __        " \~ |
 | ~~~ / /   .-' , / ' _,'_  -  _ '- _`._ `.`-._    _/- `--.   " " \~|
 |  ~ / / _-- `---,~.-' __   --  _,---.  `-._   _,-'- / ` \ \_   " |~|
 | ~ | | -- _    /~/  `-_- _  _,' '  \ \_`-._,-'  / --   \  - \_   / |
 |~~ | \ -      /~~| "     ,-'_ /-  `_ ._`._`-...._____...._,--'  /~~|
 | ~~\  \_ /   /~~/    ___  `---  ---  - - ' ,--.     ___        |~ ~|
 |~   \      ,'~~|  " (o o)   "         " " |~~~ \_,-' ~ `.     ,'~~ |
 | ~~ ~|__,-'~~~~~\    \"/      "  "   "    /~ ~~   O ~ ~~`-.__/~ ~~~|
 |~~~ ~~~  ~~~~~~~~`.______________________/ ~~~    |   ~~~ ~~ ~ ~~~~|
 |____~jrei~__~_______~~_~____~~_____~~___~_~~___~\_|_/ ~_____~___~__|
 / \----- ----- ------------  ------- ----- -------  --------  -------\
 \_/__________________________________________________________________/
 You found a map, now you know where the treasure is.